grid 10x12
spawn 7,3
0 0 0 0 0 4 4 4 4 4 0 0
4 4 4 4 0 4 0 0 0 4 4 0
4 0 0 4 4 4 0 4 0 0 4 0
4 0 2 1 1 1 1 1 4 0 4 4
4 0 0 4 4 1 1 1 2 0 0 4
4 0 0 0 0 2 4 4 2 4 0 4
4 0 2 4 2 0 0 0 2 0 0 4
4 4 0 0 0 4 4 4 2 4 0 4
0 4 4 4 4 4 0 4 0 0 0 4
0 0 0 0 0 0 0 4 4 4 4 4

grid 7x8
spawn 4,6
4 4 4 4 4 4 0 0
4 0 0 0 0 4 0 0
4 0 2 2 2 4 4 4
4 0 1 1 2 0 0 4
4 4 1 1 1 2 0 4
0 4 0 0 4 4 4 4
0 4 4 4 4 0 0 0

grid 8x10
spawn 1,2
4 4 4 4 4 4 4 0 0 0
4 0 0 4 0 0 4 4 0 0
4 0 0 4 0 0 0 4 0 0
4 0 2 0 2 0 2 4 0 0
4 0 0 4 4 2 0 4 0 0
0 4 0 4 0 2 0 4 4 4
0 4 0 0 1 1 1 1 1 4
0 4 4 4 4 4 4 4 4 4

grid 8x11
spawn 6,9
0 0 4 4 4 4 4 4 0 0 0
0 0 4 1 1 1 0 4 0 0 0
0 0 4 1 1 1 1 4 4 4 4
4 4 4 0 2 4 4 4 0 0 4
4 0 2 2 0 0 2 0 2 0 4
4 0 0 0 0 2 0 2 0 0 4
4 0 0 0 4 4 4 0 0 0 4
4 4 4 4 4 0 4 4 4 4 4

grid 8x8
spawn 6,3
0 0 4 4 4 4 0 0
0 0 4 1 1 4 0 0
0 4 4 1 0 4 4 0
0 4 1 2 0 0 4 0
4 4 0 0 2 0 4 4
4 0 2 2 4 0 0 4
4 0 0 0 0 0 0 4
4 4 4 4 4 4 4 4

grid 9x9
spawn 5,1
0 0 4 4 4 4 0 0 0
0 0 4 0 0 4 0 0 0
0 0 4 0 0 4 0 0 0
4 4 4 0 1 4 4 4 4
4 0 0 1 2 0 0 0 4
4 0 2 1 1 0 2 0 4
4 4 4 0 2 4 4 4 4
0 0 4 0 0 4 0 0 0
0 0 4 4 4 4 0 0 0

grid 10x14
spawn 4,5
0 0 0 4 4 4 4 4 4 4 4 4 4 4
4 4 4 0 0 0 0 0 4 0 0 1 1 4
4 0 0 2 0 0 2 0 4 0 0 1 1 4
4 0 0 4 4 4 4 2 4 0 0 1 1 4
4 0 0 4 4 0 0 0 0 0 0 1 1 4
4 4 0 2 0 0 4 0 4 0 0 1 1 4
4 0 2 0 2 4 4 0 4 4 4 4 4 4
4 0 2 0 2 0 2 0 0 2 0 4 0 0
4 0 0 0 0 0 4 0 0 0 0 4 0 0
4 4 4 4 4 4 4 4 4 4 4 4 0 0

grid 8x9
spawn 1,1
4 4 4 4 4 4 0 0 0
4 0 0 0 1 4 4 4 4
4 0 0 2 2 2 0 0 4
4 1 4 4 1 4 4 1 4
4 0 0 0 2 0 0 0 4
4 4 0 4 1 2 0 0 4
0 4 0 0 0 4 4 4 4
0 4 4 4 4 4 0 0 0

grid 8x8
spawn 6,3
0 4 4 4 4 4 4 0
0 4 1 1 0 1 4 0
0 4 1 2 0 1 4 0
4 4 2 0 0 4 4 4
4 0 2 0 0 2 0 4
4 0 4 4 2 4 0 4
4 0 0 0 0 0 0 4
4 4 4 4 4 4 4 4

grid 8x7
spawn 6,2
4 4 4 4 4 4 4
4 1 1 2 1 1 4
4 1 1 4 1 1 4
4 0 2 2 2 0 4
4 0 0 2 0 0 4
4 0 2 2 2 0 4
4 0 0 4 0 0 4
4 4 4 4 4 4 4

grid 7x11
spawn 4,2
4 4 4 4 4 4 4 4 0 0 0
4 0 1 0 0 0 0 4 4 4 4
4 0 1 2 0 2 0 2 0 0 4
4 4 1 4 4 4 4 1 0 0 4
0 4 0 0 2 0 2 1 2 0 4
0 4 4 4 4 0 0 1 0 0 4
0 0 0 0 4 4 4 4 4 4 4

grid 9x15
spawn 6,7
0 0 0 0 0 0 0 0 4 4 4 4 4 0 0
4 4 4 4 4 4 4 4 4 0 0 0 4 0 0
4 0 0 0 0 0 0 0 2 0 2 0 4 0 0
4 0 0 2 2 4 0 2 0 0 4 4 4 4 4
4 4 4 0 0 0 0 4 4 0 4 0 0 0 4
0 0 4 2 0 0 4 4 0 0 0 1 1 1 4
0 0 4 0 0 2 0 0 2 2 4 1 1 1 4
0 0 4 4 0 0 4 0 0 0 4 1 1 1 4
0 0 0 4 4 4 4 4 4 4 4 4 4 4 4

grid 10x12
spawn 8,10
4 4 4 4 4 4 0 0 0 0 0 0
4 0 0 0 1 4 4 4 4 4 4 0
4 0 0 0 1 1 4 0 0 0 4 0
4 0 0 0 1 1 2 0 0 0 4 0
4 4 0 4 1 0 4 0 0 0 4 0
4 0 0 4 2 4 4 0 4 4 4 4
4 0 2 2 0 0 0 0 2 0 0 4
4 0 0 4 0 0 4 2 4 0 0 4
4 4 4 4 4 4 4 0 0 0 0 4
0 0 0 0 0 0 4 4 4 4 4 4

grid 10x16
spawn 2,1
0 0 0 0 0 4 4 4 4 4 4 4 4 4 4 4
4 4 4 4 4 4 1 1 1 1 1 2 0 0 0 4
4 0 0 0 0 4 4 4 4 4 4 0 2 0 0 4
4 0 2 2 0 4 0 0 0 0 0 2 0 2 0 4
4 0 0 0 2 0 0 2 4 4 4 0 2 0 0 4
4 0 0 2 0 0 2 0 0 1 1 2 0 0 0 4
4 4 4 0 2 4 2 0 4 4 4 4 4 4 4 4
0 0 4 0 0 4 0 2 1 1 1 1 4 0 0 0
0 0 4 0 0 4 0 0 1 1 1 1 4 0 0 0
0 0 4 4 4 4 4 4 4 4 4 4 4 0 0 0

grid 10x15
spawn 7,8
0 4 4 4 4 4 4 4 4 4 4 4 4 4 0
0 4 0 0 0 0 0 0 4 0 0 0 0 4 0
4 4 2 0 0 2 2 0 4 0 2 2 2 4 0
4 0 1 1 1 1 0 0 4 0 0 2 0 4 0
4 0 1 4 4 1 2 4 0 0 2 0 0 4 0
4 0 1 1 1 1 0 4 2 0 4 0 0 4 0
4 0 1 4 4 1 2 4 0 0 2 0 2 4 4
4 0 1 1 1 1 2 0 0 2 0 0 2 0 4
4 4 4 4 4 4 0 0 4 4 4 0 0 0 4
0 0 0 0 0 4 4 4 4 0 4 4 4 4 4

grid 10x13
spawn 8,10
4 4 4 4 4 0 0 4 4 4 4 4 4
4 0 0 0 4 4 4 4 0 0 0 0 4
4 0 4 0 0 0 2 0 0 0 2 0 4
4 0 2 0 4 4 4 0 4 0 0 4 4
4 0 4 2 4 4 4 0 0 2 2 4 0
4 0 1 1 1 0 0 4 0 0 0 4 4
4 1 1 1 2 0 0 2 0 4 0 0 4
4 4 4 1 1 4 4 4 4 4 0 0 4
0 0 4 4 4 4 0 0 0 4 0 0 4
0 0 0 0 0 0 0 0 0 4 4 4 4

grid 11x13
spawn 4,3
4 4 4 4 4 0 0 0 0 0 0 0 0
4 0 0 0 4 0 0 0 0 0 0 0 0
4 0 4 0 4 4 4 4 4 4 4 4 4
4 0 0 0 2 0 2 0 2 0 2 0 4
4 4 2 0 4 0 4 0 4 0 4 0 4
0 4 0 0 0 1 1 1 1 1 1 1 4
4 4 4 2 4 1 4 1 4 1 4 0 4
4 0 0 0 2 0 2 0 2 0 2 0 4
4 0 4 0 4 4 4 4 4 4 4 4 4
4 0 0 0 4 0 0 0 0 0 0 0 0
4 4 4 4 4 0 0 0 0 0 0 0 0

grid 7x12
spawn 3,10
4 4 4 4 4 4 4 4 4 4 4 4
4 4 0 2 1 1 2 1 0 2 0 4
4 0 0 2 1 1 2 1 0 2 0 4
4 0 0 2 1 1 2 1 0 2 0 4
4 0 0 2 1 1 2 1 0 2 0 4
4 0 0 2 1 1 2 1 0 2 0 4
4 4 4 4 4 4 4 4 4 4 4 4

grid 10x18
spawn 5,15
4 4 4 0 0 0 0 0 0 4 4 4 4 4 4 4 4 4
4 1 4 4 4 4 4 4 4 4 0 0 0 4 0 0 0 4
4 1 1 1 1 4 0 0 0 4 0 0 2 0 2 0 0 4
4 1 1 1 1 4 0 0 2 0 2 0 2 0 2 0 4 4
4 1 4 1 2 1 2 0 2 0 2 0 2 0 2 0 4 0
4 1 4 1 2 1 2 0 2 0 2 0 2 0 2 0 4 0
4 1 1 1 1 4 0 0 2 0 2 0 2 0 2 0 4 4
4 1 1 1 1 4 0 0 0 4 0 0 2 0 2 0 0 4
4 1 4 4 4 4 4 4 4 4 0 0 0 4 0 0 0 4
4 4 4 0 0 0 0 0 0 4 4 4 4 4 4 4 4 4

grid 7x7
spawn 3,3
4 4 4 4 4 4 4
4 1 0 1 0 1 4
4 0 2 2 2 0 4
4 1 2 0 2 1 4
4 0 2 2 2 0 4
4 1 0 1 0 1 4
4 4 4 4 4 4 4